Imports System
Imports System.Collections.Generic
Imports System.Linq
Imports System.Text

Namespace Objects.Positioners
    Public Class BurchfieldCommand

        Public Const PanAxis = "M1"
        Public Const TiltAxis = "M2"
        Public Const TiltAxis2 = "M3"
        Public Const TopPlatform = "M4"
        Public Const StabilizationCard = "SC"

        Public Const Reset = "GOSUB4" 'EDITED

        Public Const TurnOnStabilization = "GOSUB8" 'EDITED
        Public Const TurnOffStabilization = "GOSUB9" 'EDITED

        Public Const AwaitCommand = "A" 'NOT USED
        Public Const Go = "G" 'EDITED

        Public Const SetAbsolutePosition = "PT=" 'EDITED
        Public Const SetRelativePosition = "PRT=" 'EDITED
        Public Const GetPosition = "RPA" 'EDITED
        Public Const GetTargetPosition = "RPT" 'EDITED
        Public Const GetCommandedPosition = "RPC" 'EDITED

        Public Const SetSpeed = "VT=" 'EDITED
        Public Const GetCurrentSpeed = "RVA" 'EDITED
        Public Const GetCommandedSpeed = "RVC" 'EDITED
        Public Const GetTargetSpeed = "RVT" 'EDITED

        Public Const SetAccelDecel = "ADT=" 'EDITED
        Public Const SetAcceleration = "AT=" 'EDITED
        Public Const SetDeceleration = "DT=" 'EDITED
        Public Const GetTargetAcceleration = "RAT" 'EDITED

        Public Const SetModePosition = "MP" 'EDITED
        Public Const SetModeVelocity = "MV" 'EDITED
        Public Const SetModeTourque = "MT" 'EDITED

        Public Const EnablePositionLimits = "SLE" 'EDITED
        Public Const DisablePositionLimits = "SLD" 'EDITED

        Public Const SetPositiveLimit = "SLP=" 'EDITED
        Public Const GetPositiveLimit = "RSLP" 'EDITED
        Public Const SetNegativeLimit = "SLN=" 'EDITED
        Public Const GetNegativeLimit = "RSLN" 'EDITED

        Public Const Halt = "S" 'EDITED

        Public Const Stow = SetAbsolutePosition & "0" 'EDITED

        Public Const GetTemp = "RTEMP" 'EDITED

        Public Const GetVoltage = "RUJA" 'EDITED

        Public Const GetCurrent = "RUIA" 'EDITED

        Public Const ClearErrors = "ZS" 'EDITED

        Public Const GetResolution = "Rrr" 'EDITED

        Public Const CheckHome = "Rh" 'EDITED

        Public Const EnableTerseFeedback = "FT"
        Public Const EnableVerboseFeedback = "FV"

        Public Const QueryEchoMode = "E"
        Public Const EnableEchoing = "EE"
        Public Const DisableEchoing = "ED"


        Public Const EnableContinuousPanRotation = "%%1CPT"
        Public Const DisableContinuousPanRotation = "%%1CPF"
        Public Const GetFirmwareVersion = "V"
        Public Const RestoreFactoryDefaults = "DF"

    End Class
End Namespace
